#####
# O #
#   #
#   #
#   #
#   #
#   #
#   #
# A #
#####