#########
#  OOO  #
#  @@@  #
#       #
#       #
#       #
#       #
#       #
#   A   #
#########